15
1
1
222222222222222
211111211222222
222221111222222
222221222222222
222221222222222
221111111222222
221222221222222
221222221222222
211111111222222
211111111222222
211111111222222
211111111222222
211111111222222
222222222222222
222222222222222