11
1
1
22222222223
21111121123
22222111123
22222122223
32222122223
32111111123
32122222123
32122222123
31111111123
32222222223
33333333333